S..........
#########.#
...........
.##########
...........
#########.#
...........
.##########
...........
#########.#
..........G
