S..#.......
.#.#.#####.
.#.#.#...#.
.#.#.#.#.#.
.#.#.#.#.#.
.#...#.#...
.#####.###.
.......#...
.#####.#.#.
.......#.#.
#######..#G
