S..........
.#########.
.#.......#.
.#.#####.#.
.#.#...#.#.
.#.#.#.#.#.
.#.#.#.#.#.
.#.#.#.#.#.
.#.#.#.#.#.
.#...#...#.
..........G
